[info]
img:muros.png
mapa:....................
     #..##..##a.##.a##aa#
     aaaa.a...a...aa..a.a
     #..##a.##aa##a.##a.#
     .aa..a...a.aa.a..aaa
     #aa##aa##aa##a.##..#
     .aa.a..aa..aaa.a...a
     #..##..##..##a.##..#
     .aa...aaa....aa.aaa.
     #..##..##a.##a.##..#
     ..aa.......aa.......
     #..##..##..##..##..#
     aa...aa.a......a....

[.]
tipo:vacio
fil:3
col:17

[#]
tipo:muro
fil:0
col:0

[a]
tipo:bloque
fil:0
col:1

[s]
tipo:spawner
fil:0
col:5
